000000000000000000000000000000000000000
000000000000000000000000000000000000000
000000000000000000000000000000000000000
000000000000000000000000000000000000000
000000000000000000000000000000000000000
000000000000000000000000000000000000000
220000000000000000222000000222222222200
112222222222222222111100001111111111111
111111111111111111111100000111111111111
000111111111111111111100000011111111111
000000000111111111111100000000000000000
222222222111111111111100000000000000000
111111111111111111111100000000000000000